abkhazian       : абхазский
ainu            : айнский
arabic          : арабский
armenian        : армянский
amharic         : амхарский
balinese        : балийский
bamum           : бамум
batak           : батакский
bengali         : бенгальский
buhid           : бухид
buginese        : бугийский
bulgarian       : болгарский
burmese         : бирманский
celtic          : кельтский
cham            : чамский
cherokee        : чероки
chinese         : китайский
cia-cia         : чиа-чиа
coptic          : коптский
cree            : кри
croatian        : хорватский
dravidian       : дравидийский
ethiopian-semitic : эфиосемитские
english         : английский
french          : французский
georgian        : грузинский
german          : немецкий
greek           : греческий
hanunoo         : хануноо
hebrew          : еврейский
hindi           : хинди
italian         : итальянский
indian          : индийские
japanese        : японский
javanese        : яванский
kayah           : каренские
khmer           : кхмерский
komi            : коми
korean          : корейский
kurd            : курдский
laotian         : лаосский
lepcha          : лепча
limbu           : лимбу
lisu            : лису
makassarese     : макасарский
maldivian       : мальдивский
maltese         : мальтийский
mandaic         : мандейский
mandar          : мандарский
marathi         : маратхи
mongolian       : монгольский
nko             : нко
okinawan        : окинавский
old-church-slavic : церковнославянский
old-italic      : италийский
oriya           : ория
palauan         : палауский
palaun          : палаун
pali            : пали
polish          : польский
punjabi         : пенджабский
persian         : персидский
pictish         : пиктский
primitive-irish : древнеирландский
rejang          : реджангский
runic           : рунический
russian         : русский
sami            : саамские
sanskrit        : санскрит
santali         : сантали
sasak           : сасакский
saurashtra      : саурашта
sinhalese       : сингальский
slovenian       : словенский
sundanese       : сунданский
sylheti         : силхетский
syrian          : сирийский
tagalog         : тагальский
tamil           : тамильский
telugu          : телугу
thai            : тайский
tibetan         : тибетский
tigtinya        : тигринья
tuareg          : тамашек
turkish         : турецкий
ukrainian       : украинский
uyghur          : уйгурский
vai             : ваи
vietnamese      : вьетнамский
yi              : И
yiddish         : идиш