# __________________________________________________________
#
# Language File: Thai (ภาษาไทย) - TH by Thanapon Namjittrong
# __________________________________________________________

abkhazian       : ภาษาอับฮาเซีย
ainu            : ภาษาไอนุ
arabic          : ภาษาอาหรับ
armenian        : ภาษาอาร์เมเนีย
amharic         : ภาษาแอมฮาริค
balinese        : ภาษาบาหลี
bamum           : ภาษาบามุม
batak           : ภาษาบาตัก
bengali         : ภาษาเบงกาลี
buhid           : ภาษาบูฮิด
buginese        : ภาษาบูกิส
bulgarian       : ภาษาบัลแกเรีย
burmese         : ภาษาพม่า
celtic          : ภาษาเคลต์
cham            : ภาษาจาม
cherokee        : ภาษาเชอโรกี
chinese         : ภาษาจีน
cia-cia         : ภาษาออสโตรนีเซียน
coptic          : ภาษาคอปติก
cree            : ภาษาครี
croatian        : ภาษาโครเอเชีย
dravidian       : ภาษากุย
ethiopian-semitic : ภาษาเอธิโอเปีย-เซมิติก
english         : ภาษาอังกฤษ
french          : ภาษาฝรั่งเศส
georgian        : ภาษาจอร์เจีย
german          : ภาษาเยอรมัน
greek           : ภาษากรีก
hanunoo         : ภาษาฮานูโนโอ
hebrew          : ภาษาฮีบรู
hindi           : ภาษาฮินดี
italian         : ภาษาอิตาลี
indian          : ภาษาอีนเดีย
japanese        : ภาษาญี่ปุ่น
javanese        : ภาษาชวา
kayah           : ภาษากะยา
khmer           : ภาษาเขมร
komi            : ภาษาโคมิ
korean          : ภาษาเกาหลี
kurd            : ภาษาเคิร์ด
laotian         : ภาษาลาว
lepcha          : ภาษาเลปชา
limbu           : ภาษาลิมบู
lisu            : ภาษาลีสู่
makassarese     : ภาษามากัสซาร์
maldivian       : ภาษาดิเวฮิ
maltese         : ภาษามอลตา
mandaic         : ภาษามันดาอิก
mandar          : ภาษาสเปน
marathi         : ภาษามราฐี
mongolian       : ภาษามองโกเลีย
nko             : ภาษาอึนโก
okinawan        : ภาษาโอะกินะวะ
old-church-slavic : ภาษาโบสถ์สลาโวนิกโบราณ
old-italic      : ภาษาอิตาลีโบราณ
oriya           : ภาษาโอริยา
palauan         : ภาษาปาเลา
palaun          : ภาษาปาเลา
pali            : ภาษาบาลี
polish          : ภาษาโปแลนด์
punjabi         : ภาษาปัญจาบ
persian         : ภาษาเปอร์เซีย
pictish         : ภาษาพิคท์
primitive-irish : ภาษาไอริช
rejang          : ภาษาเรชัง
runic           : ภาษารูน
russian         : ภาษารัสเซีย
sanskrit        : ภาษาสันสกฤต
santali         : ภาษาสันตาลี
sami            : ภาษาซามิ
sasak           : ภาษาซาซะก์
saurashtra      : ภาษาเสาราษฏร์
sinhalese       : ภาษาสิงหล
slovenian       : ภาษาสโลวีเนีย
sundanese       : ภาษาซุนดา
sylheti         : ภาษาสิเลฏี
syrian          : ภาษาซีเรียค
tagalog         : ภาษาตากาล็อก
tamil           : ภาษาทมิฬ
telugu          : ภาษาเตลูกู
thai            : ภาษาไทย
tibetan         : ภาษาทิเบต
tigtinya        : ภาษาทิกรินยา
tuareg          : ภาษาทัวเร็ก
turkish         : ภาษาตุรกี
ukrainian       : ภาษายูเครน
uyghur          : ภาษาอุยกูร์
vai             : ภาษาไว
vietnamese      : ภาษาเวียดนาม
yi              : ภาษายิ
yiddish         : ภาษายิดดิช