control-character : Управляющие символы
basic-latin     : Основная латиница
latin-1-supplement : Расширенная латиница-1
latin-extended-A : Расширенная латиница-A
latin-extended-B : Расширенная латиница-B
ipa-extensions  : Международный фонетический алфавит
spacing-modifier-letters : Некомбинируемые протяжённые символы-модификаторы
combining-diacritical-marks : Комбинируемые диакритические знаки
greek-coptic    : Греческий и коптский алфавиты
cyrillic        : Кириллица
cyrillic-supplement : Кириллица. Дополнительные символы
armenian        : Армянский алфавит
hebrew          : Иврит
arabic          : Арабский
syrian          : Сирийский
arabic-supplement : Дополнительные символы арабского письма
thaana          : Тана
nko             : Нко
samaritan       : Самаритянское письмо
mandaic         : Мандейский алфавит
arabic-extended-a : Расширенный набор символов арабского письма-A
devanagari      : Деванагари
bengali         : Бенгальский
gurmukhi        : Гурмухки
gujarati        : Гуджарати
oriya           : Ория
tamil           : Тамильская письменность
telugu          : Телугу
kannada         : Каннада
malayalam       : Малаялам
sinhala         : Сингальская письменность
thai            : Тайская письменность
lao             : Лаосская письменность
tibetan         : Тибетская письменность
myanmar         : Бирманский
georgian        : Грузинский
hangul-jamo     : Хангыль
ethiopic        : Эфиопская слоговая письменность
ethiopic-supplement : Дополнительные символы эфиопской письменности
cherokee        : Письменность чероки
unified-canadian-aboriginal-syllabics : Канадское слоговое письмо
ogham           : Огамическое письмо
runic           : Руническая письменность
tagalog         : Тагальская письменность. Байбайин
hanunoo         : Хануноо
buhid           : Бухид
tagbanwa        : Тагбанва
khmer           : Кхмерская письменность
mongolian       : Старомонгольская письменность
unified-canadian-aboriginal-syllabics-extended : Расширенный набор символов канадского слогового письма
limbu           : Письменность лимбу
tai-le          : Письменность тай лэ
new-tai-lue     : Новый алфавит тай лы
khmer-symbols   : Кхмерские символы
buginese        : Бугийская письменность. Лонтара
tai-tham        : Старый алфавит тай лы. Тай Тхам
balinese        : Балийское письмо
sundanese       : Сунданское письмо
batak           : Батакское письмо
lepcha          : Письмо лепча
ol-chiki        : Письменность Ол-чики
sundanese-supplement : Сунданское расширенное письмо
vedic-extensions : Ведические символы
phonetic-extentions : Фонетические расширения
phonetic-extentions-supplement : Дополнительные фонетические расширения
combining-diacritical-marks-supplement : Дополнительные комбинируемые диакритические знаки
latin-extended-additional : Дополнительная расширенная латиница
greek-extended  : Расширенный набор символов греческого алфавита
general-punctuation : Знаки пунктуации
superscripts-and-subscripts : Надстрочные и подстрочные знаки
currency-symbols : Символы валют
combining-diacritical-marks-for-symbols : Комбинируемые диакритические знаки для символов
letterlike-symbols : Буквоподобные символы
number-forms    : Числовые формы
arrows          : Стрелки
mathematical-operators : Математические операторы
miscellaneous-technical : Разнообразные технические символы
control-pictures : Значки управляющих кодов
optical-character-recognition : Символы оптического распознавания
enclosed-alphanumerics : Вложенные буквы и цифры
box-drawing     : Символы для рисования рамок
block-elements  : Символы заполнения
geometric-shapes : Геометрические фигуры
miscellaneous-symbols : Разнообразные символы
dingbats        : Дингбаты
miscellaneous-mathematical-symbols-a : Разнообразные математические символы-A
suplemental-arrows-a : Дополнительные стрелки-A
braille-patterns : Азбука Брайля
suplemental-arrows-b : Дополнительные стрелки-B
miscellaneous-mathematical-symbols-b : Разнообразные математические символы-B
supplemental-mathematical-operators : Дополнительные математические операторы
miscellaneous-symbols-and-arrows : Разнообразные символы и стрелки
glagolitic      : Глаголица
latin-extended-c : Расширенная латиница C
coptic          : Коптский алфавит
georgian-supplement : Дополнительные символы грузинского алфавита
tifinagh        : Тифинаг (Древнеливийское письмо)
ethiopic-extended : Расширенный набор символов эфиопского письма
cyrillic-extended : Расширенная кириллица A
supplemental-punctuation : Дополнительные знаки пунктуации
cjk-radicals-supplement : Дополнительные иероглифические ключи ККЯ
kangxi-radicals : Иероглифические ключи словаря Канси
ideographic-description-characters : Символы описания иероглифов
cjk-symbols-and-punctuation : Символы и пунктуация ККЯ
hiragana        : Хирагана
katakana        : Катакана
bopomofo        : Чжуинь. Бопомофо
hangul-compatibility-jamo : Чамо, комбинируемое с хангылем
kanbun          : Канбун(китайский)
bopomofo-extended : Расширенный набор символов бопомофо, чжуинь
cjk-strokes     : Черты ККЯ
katakana-phonetic-extentions : Фонетические расширения катаканы
enclosed-cjk-letters-and-months : Вложенные буквы и месяцы ККЯ
cjk-compatibility : Знаки совместимости ККЯ
cjk-unified-ideographs-extension-a : Унифицированные иероглифы ККЯ
yijing-hexagram-symbols : Гексаграммы И-Цзин
cjk-unified-ideographs : Унифицированные иероглифы ККЯ
yi-syllables    : Слоги. Письмо И
yi-radicals     : Радикалы. Письмо И
old-lisu-alphabet : Слоговая письменность ваи
ciryllic-extended-B : Расширенная кириллица-B
bamum           : Письмо бамум
modifier-tone-letters : Символы изменения тона
latin-extended-d : Расширенная латиница-D
syloty-nagri    : Силоти нагри
indian-numeric-character : Индийские числовые символы
phags-pa        : Квадратное письмо Пагба-ламы
saurashtra      : Саураштра
devanagari-extended-characters : Расширенный набор символов деванагари
kayah-li        : Кайях Ли
rejang          : Реджанг
hangul          : Хангыль
javanese-alphabet : Яванская письменность
cham-alphabet   : Тямское письмо
burmese-alphabet-extention-a : Мьянманская письменность. Расширение A
tai-viet-alphabet : Письменность Тай Вьет
meitei-language-extentions : Мейтей расширенная
ethiopic-extended-a : Набор расширенных символов эфиопского письма-А
meitei-language : Мейтей (Манипури)
hangul-syllables : Слоги Хангыля
high-surrogates : Верхняя часть суррогатных пар
high-private-use-surrogates : Верхняя часть суррогатных пар для частного использования
low-surrogates  : Нижняя часть суррогатных пар
private-use-area : Область для частного использования
cjk-compatibility-ideographs : Совместимые иероглифы ККЯ
alphabetic-presentation-forms : Алфавитные формы представления
arabic-presentation-forms-a : Формы представления арабских букв-A
variation-selectors : Селекторы вариантов начертания
vertical-forms  : Вертикальные формы
combining-half-marks : Комбинируемые половинки символов
cjk-compatibility-forms : Формы совместимости ККЯ
small-form-variants : Варианты малого размера
arabic-presentation-forms-b : Формы представления арабских букв-B
halfwidth-and-fullwidth-forms : Полуширинные и полноширинные формы
specials        : Специальные символы

linear-b-syllabary : Слоги линейного письма Б
linear-b-ideograms : Идеограммы линейного письма Б
aegean-numbers : Эгейские цифры
ancient-greek-numbers : Древнегреческие цифры
ancient-symbols : Древние символы
phaistos-disc : Символы фестского диска
lycian : Ликийский алфавит
carian : Алфавит карийского языка
coptic-epact-numbers : Коптские epact-числа
old-italic : Этрусский (староитальянский) алфавит
gothic : Готский алфавит
old-permic : Древнепермское письмо
ugaritic : Угаритский алфавит
old-persian : Древнеперсидский клинописный алфавит
deseret : Дезеретский алфавит
shavian : Алфавит Бренарда Шоу
osmanya : Османия (сомалийский алфавит)
elbasan : Эльбасанское письмо
caucasian-albanian : Агванское письмо (Кавказская Албания)
linear-a : Линейное письмо А
cypriot-syllabary : Слоговая письменность острова Крит
imperial-aramaic : Арамейское письмо
palmyrene : Диалект Пальмиры
nabataean : Набатейское письмо
phoenician : Финикийское письмо
lydian : Лидийский алфавит
meroitic-hieroglyphs : Иероглифическое мероитское письмо
meroitic-cursive : Курсивное мероитское письмо
kharoshthi : Кхароштхи
old-south-arabian : Старый южноаравийский алфавит
old-north-arabian : Старый североаравийский алфавит
manichaean : Манихейское письмо
avestan : Авестийский алфавит
inscriptional-parthian : Пехлевийское письмо для парфянского языка
inscriptional-pahlavi : Эпиграфическое пехлевийское письмо
psalter-pahlavi : Псалтырь пехлеви
old-turkic : Древнетюркское руническое письмо
rumi-numeral-symbols : Цифры системы руми
brahmi : Брахмическая письменность
kaithi : Кайтхи
sora-sompeng : Sora Sompeng
chakma : Chakma
mahajani : Mahajani
sharada : Sharada
sinhala-archaic-numbers : Sinhala Archaic Numbers
khojki : Khojki
khudawadi : Khudawadi
grantha : Grantha
tirhuta : Tirhuta
siddham : Siddham
modi : Modi
takri : Takri
warang-citi : Warang Citi
pau-cin-hau : Pau Cin Hau
cuneiform : Cuneiform
cuneiform-numbers-and-punctuation : Cuneiform Numbers and Punctuation
egyptian-hieroglyphs : Egyptian Hieroglyphs
bamum-supplement : Bamum Supplement
mro : Mro
bassa-vah : Bassa Vah
pahawh-hmong : Pahawh Hmong
miao : Miao
kana-supplement : Kana Supplement
duployan : Duployan
shorthand-format-controls : Shorthand Format Controls
byzantine-musical-symbols : Byzantine Musical Symbols
musical-symbols : Musical Symbols
ancient-greek-musical-notation : Ancient Greek Musical Notation
tai-xuan-jing-symbols : Tai Xuan Jing Symbols
counting-rod-numerals : Counting Rod Numerals
mathematical-alphanumeric-symbols : Mathematical Alphanumeric Symbols
mende-kikakui : Mende Kikakui
arabic-mathematical-alphabetic-symbols : Arabic Mathematical Alphabetic Symbols
mahjong-tiles : Mahjong Tiles
domino-tiles : Domino Tiles
playing-cards : Playing Cards
enclosed-alphanumeric-supplement : Enclosed Alphanumeric Supplement
enclosed-ideographic-supplement : Enclosed Ideographic Supplement
miscellaneous-symbols-and-pictographs : Miscellaneous Symbols And Pictographs
emoticons : Emoticons
ornamental-dingbats : Ornamental Dingbats
transport-and-map-symbols : Transport And Map Symbols
alchemical-symbols : Alchemical Symbols
geometric-shapes-extended : Geometric Shapes Extended
supplemental-arrows-c : Supplemental Arrows-C