title           : Tabla de caracteres Unicode
search          : Buscar personaje
find            : Encontrar
example         : Ejemplo
example_text    : Arroba;A mayúscula con tilde;Fracción vulgar de un cuarto
about           : Sobre el proyecto
not_language    : Where is my language?
popular         : Personajes más populares
loading         : Cargando, espera por favor ...
unicode_number  : Número Unicode
html_code       : <span class="caps">HTML</span>-código
uppercase       : mayúsculas
lowercase       : minúsculas
encoding        : Codificación
block           : Bloque
set             : Conjunto
up              : Hasta
range           : Alcance
type            : Tipo
countries       : Países
count           : Número de caracteres
languages       : Idiomas
sort_order      : Por orden
sort_block      : Por secciones
copy_clipboard  : Copiar al portapapeles
search_h1       : Buscar
search_result   : resultar
search_empty    : Buscar frase está vacía
search_total    : Total: %s
search_limit    : (mostrar sólo %s)
search_none     : Ninguno
search_any      : Buscar por cualquier palabra
help_range      : Haga clic para resaltar gama
blocks_list     : Lista de Secciones Unicode
languages_list  : Lista de las Lenguas
languages_blocks : Secciones del lenguaje
types_list      : Lista de Tipos
countries_list  : Lista de Países
more            : más
sets            : Los conjuntos de caracteres
ny_symbols      : Navidad y símbolos del Año Nuevo
prev            : Ant
next            : Próx
entity          : Entidad
search_overflow : Lo sentimos, símbolo U +% s está en construcción :)
feedback        : Feedback
separate_page   : Abrir en una página independiente
edit            : Editar
save            : Guardar
undo            : Deshacer
send_changes    : Los cambios se envían a los desarrolladores de sitios web. Estás seguro?
gotofullversion : Ir a la versión completa


# __________________________________________________________
#
# FOOTER
# __________________________________________________________

feedback        : Feedback
github          : GitHub
twitter         : Twitter
join_us         : Quiero unirme a
donate          : Cómo donar
unicode         : Unicode
about_unicode   : Acerca de Unicode
unicode_history : Historia Unicode
unicode_versions: Versiones Unicode
broken_chars    : Algunos caracteres no se muestren
cyrillic        : Cirílico
fonts           : Fuentes



# __________________________________________________________
#
# TOOLS / Instrumentos  http://unicode-table.com/tools/
# __________________________________________________________

tools           : Instrumentos
encoder         : Encoder
encoder-desc    : Codifica los caracteres en el código HTML y la espalda
encoder-plain   : Texto sin formato
encoder-full    : Completo
encoder-text    : Texto
encoder-entities: Codifica los caracteres con entidades
encoder-br      : Codifica los saltos de línea

decoder         : Decodificador
decoder-desc    : Codifica los caracteres Unicode en la espalda o decodifica
decoder-example : Este es un ejemplo
decoder-code    : Unicode
decoder-text    : Texto

flip            : Voltear
flip-desc       : Voltear los caracteres cirílicos y América al revés
flip-plain      : Texto sin formato
flip-flipped    : Flipped texto
flip-backed     : Volver al texto delante

toolsgenerator : Tabla
toolsgenerator-range: Rango
toolsgenerator-format: Formato
toolsgenerator-info: permitir {symbol}, {dec}, {hex}, {html}
toolsgenerator-text: texto para la copia
toolsgenerator-file: descargar archivo

toolsgenerator : Generador de tabla de caracteres Unicode
toolsgenerator-desc : Genera un conjunto de caracteres en un rango especificado
toolsgenerator-range: Alcance
toolsgenerator-format: Formato
toolsgenerator-info: Disponible: {symbol}, {dec}, {hex}, {html}
toolsgenerator-text-generate: Generar
toolsgenerator-result: Resultado

# CONTENT

content-sorry: Lo sentimos, no hay más información en el momento.
content-sorry-lang: Lo sentimos, más información en Inglés no está disponible. Estamos trabajando para su puesta a disposición en breve.
content-other: El texto también está disponible en los siguientes idiomas:
content-sorry-other: Ver otras versiones lingüísticas:

# SEO

meta_description : Todos los símbolos Unicode con nombres y descripciones en una página: ❤ ☀ ★ ☂ ☻ ♞ ☯ ☭ ☢ € → ☎ ❄ ♫ ✂ ▶ ✇ ♎ ⇧ ☮ ♻ ⌘ ⌛ ☘ ✈ ✔ ☊ ♔ ♕ ♖ ☦ ✝ ❖ ➎ ♠ ♣ ♥ ♦ ♂ ♀ ❂ ❃ ✒
meta_keywords   : Unicode, signos, símbolos, caracteres unicode, mesa, juego de caracteres, la lista de caracteres Unicode, UFT-8, facebook caracteres, la codificación, símbolo del corazón, escritura, idiomas, jeroglíficos, runas, símbolos de flecha, cirílico, latino, símbolos de moneda
symbol_description: Símbolo: {{symbol}}, Nombre: {{name}}, Unicode número: {{code}}, Bloque: {{block}}{% if entity %}, Entidad: {{ entity }}{% endif %}
symbol_title: símbolo, carácter, muestra, icono
